.............................................
.............................#####...........
.............................#...#...........
.............................#...#...........
.............................#...#...........
.............................#...#...........
.............................#...#...........
.........................#########...........
.........................#...#...............
.........................#...#...............
.........................#...#...............
.....................#########...............
.....................#...#...................
.....................#...#...................
.....................#...#...................
.................#####...#####...............
.................#...........#...............
.................#...........#...............
.................#...........#...............
.........#########...........#####...........
.........#.......................#...........
.........#.......................#...........
.........#.......................#...........
.#######.#...................#########.......
.#.....#.#...................#...#...#.......
.#.....#.#####...............#...#...#.......
.#.....#.....#...............#...#...#.......
.###########.#.######^...#####...###########.
.......#...#.#.#.........#...........#.....#.
.......#.#########.......#...........#.....#.
.......#.#.#.#.#.........#...........#.....#.
.......#########.#########...........#######.
.........#.#.#...#...........................
.....#########...#...........................
.....#...#.#.....#...........................
.....#...#.#######...........................
.....#...#...................................
.....#...#...................................
.....#...#...................................
.....#####...................................
.............................................

